8 13 31
###############################
#p    *f*      5  x *  2      #
# # # # # # # # # #*# # # # # #
# *         *      *     b    #
# # # #*# # #*# # # # # # # # #
#*    1        **  *   *      #
#*# # # # # # # # # # # # # # #
#    *   **      x     *  3   #
# # # # # # # # #*# # # # # # #
#   *    *  2   *     *       #
# #*# #*# # # # #*# #*# # # # #
#    *     4 *      **        #
###############################