4 13 31
###############################
#p       *  1 ***          * 1#
# # # # # # # # # # #x# # # # #
#*  ** * *      *  1      3   #
#*#*# # # #*# # # # # # # # #*#
#     b      *   3      * 1   #
#*# # # # # # #2# # #*# # # # #
#   *  * *     *     2        #
# # # # # #*# # # # # # # # # #
#    1 *  f    4   *  x  *    #
# # # # # # # # # # # # #4# # #
#     *   *      *  1         #
###############################