7 13 31
###############################
#p  *   1   **      *  2  s   #
# # # #*# # # # # #*# # # # # #
#  *        *4     *   x      #
# # # #*# # #*# # # # # # # # #
#    *   *      **  *   *     #
#*# # # # # # # # # # # # # # #
#    *     * 1         *  3   #
# # # # # # # # #*# # # # # # #
#   *       2   *x   5 *      #
# #*# #*# # # # #*# # # # # # #
#  *  *      * 1     *    *   #
###############################