2 13 31
###############################
#p     ** *  *1* 2 *  * * *   #
#*# # #*# # #*#*# # # #*#*#*# #
#   *     ***  *  1   * 2 * * #
# # # # # #*# # #*#*# # # # #*#
#          x **  *  *   1     #
# # # # # # # # # #*# #*# #*# #
# 1        *b *      *  *     #
# # # # #*# # # #*#*# # # # # #
#*    **  *       *   x*  *   #
# #*# # # # # # #*# # # # # # #
#      1    **  *     * *     #
###############################