5 13 31
###############################
#p   *  f        *    1   x   #
# #*# # # # # #*# # # # #2# # #
#    *    *1   *    3*   5    #
# # # # # # # # # # # # # # # #
#    *s      1        * 4     #
#*# # # # # # # # #b# # # # # #
#   *    3     *     *    *  5#
# # #*# # # #2# # # # #x# # # #
#  3         *        *   *   #
# # # # # #*# # # # # # # # # #
#      5  *4*     1  *2**     #
###############################