3 13 31
###############################
#p    *    **1f   *  *   *    #
# # # # # # # # # # # # # # # #
#* **   *  * *  *   **   *    #
#*# # # # # # # # # # # #*# # #
#1    ***     *    2    **    #
# # # # # # # # # # # # # # # #
#  *  *      s     *     *   *#
# # # # # # # # # # # # # # # #
#   *    1  *     **     *    #
# # # # # # # # # # # # # # # #
#  *    2 **1    *    x   2   #
###############################
