9 13 31
###############################
#p     *  1  s   **  *   x    #
# # #*# # # #*# # # # # # # # #
#**    *    *   *  *     b    #
#*# # #*# # #*# #4# # # # # # #
#   *    *     *   *   *      #
#*# # # # # # #*#*# # # # # # #
#    *   **   *    *   *      #
# # # #x# # # # #*# # # # # # #
#  **    *  2   *   5 *       #
# #*# #*# # # # #*# #*# # # # #
#   *       5       *3*   2   #
###############################