10 13 31
###############################
#p  *     3      **          *#
# # # #*# # # #*# # #1# # # # #
# *  *        f       *       #
# # # # # # # # # # # # #x# # #
#  *   *  *   *   5     *     #
# # # # # # # # # # # # # #*# #
#  * 1  *     *  *     4     *#
# # #*# # # # # # #*# # # # # #
#     *   *  2                #
# # # #*#*# # # # # #x# # # # #
#  *    *     **  *   *       #
###############################