2 13 31
###############################
#p     ** *  *1* 2 *  * * *   #
#*# # #*# # #*#*# # # #*#*#*# #
#   *     ***  *  1   *   * * #
# # # # # #*# # #*#*# # # # #*#
#          x **  *  *   1     #
# # # # # # # # # #*# #*# #*# #
# 1        *b *      *  *     #
# # # # #*# # # #*#*# # # # # #
#*    **  *       * 2 x*  *   #
# #*# # # # # # #*# # # # # # #
#      1    **  *     * *     #
###############################