6 13 31
###############################
#p    *x*     *b     *  5     #
# # # # # # # # # # #*# # # # #
#   **    *    * 3 *   *  *   #
# # # # # # # # # # # # # # # #
#*   *  *   *    *  5**       #
# # # # # # # # # # # # # # # #
#   *    *    3   *   * *     #
#*# # # # #*# # #*#*# # #*# # #
#   **f     1   * 3 *   *     #
# # #1# # # # # #*#*# # # # # #
#  *     *4    *    *  1      #
###############################